111111111111111111111111
100000000000000000000001
100100000C0000C10C1110C1
100111110000010100000C11
1E0011000P110001001C1001
101000000000011100000001
100000000000000000000001
100000000000000000000001
111111111111111111111111
